[
  {
    "roomIdentifier": "market",
    "position": [0, 0],
    "tile": [
      [1, 1, 1, 1, 1, 1, 1, 1, 1, 1],
      [1, 2, 0, 2, 2, 0, 2, 2, 0, 0],
      [1, 2, 0, 0, 0, 0, 0, 0, 0, 0],
      [1, 0, 0, 0, 0, 0, 0, 0, 0, 2],
      [1, 2, 0, 0, 2, 2, 2, 0, 0, 0],
      [1, 2, 0, 0, 2, 0, 0, 0, 0, 0],
      [1, 0, 0, 0, 0, 0, 0, 0, 0, 0],
      [1, 0, 0, 0, 0, 0, 0, 0, 0, 0],
      [1, 2, 2, 0, 2, 2, 0, 0, 0, 0],
      [1, 1, 1, 1, 1, 1, 1, 1, 1, 1]
    ]
  },
  {
    "roomIdentifier": "market",
    "position": [1, 0],
    "tile": [
      [1, 1, 1, 1, 1, 1, 1, 1, 1, 1],
      [0, 0, 0, 0, 0, 0, 1, 1, 1, 1],
      [0, 0, 0, 0, 0, 2, 1, 1, 1, 1],
      [2, 0, 0, 0, 0, 2, 1, 1, 1, 1],
      [0, 0, 0, 0, 0, 2, 1, 1, 1, 1],
      [0, 0, 0, 0, 0, 0, 1, 1, 1, 1],
      [0, 0, 0, 0, 0, 0, 0, 0, 0, 0],
      [0, 0, 0, 0, 0, 0, 0, 0, 0, 0],
      [0, 0, 0, 0, 0, 0, 1, 1, 1, 1],
      [1, 1, 1, 1, 1, 1, 1, 1, 1, 1]
    ]
  },
  {
    "position": [2, 0],
    "tile": [
      [1, 1, 1, 1, 1, 1, 1, 1, 1, 1],
      [1, 1, 1, 1, 1, 1, 1, 1, 1, 1],
      [1, 1, 1, 1, 1, 1, 1, 1, 1, 1],
      [1, 1, 1, 1, 1, 1, 1, 1, 1, 1],
      [1, 1, 1, 1, 1, 1, 1, 1, 1, 1],
      [1, 1, 1, 1, 1, 1, 1, 1, 1, 1],
      [0, 0, 1, 1, 1, 1, 1, 1, 1, 1],
      [0, 0, 1, 1, 1, 1, 1, 1, 1, 1],
      [0, 0, 1, 1, 1, 1, 1, 1, 1, 1],
      [0, 0, 1, 1, 1, 1, 1, 1, 1, 1]
    ]
  },
  {
    "position": [2, 1],
    "tile": [
      [0, 0, 1, 1, 1, 1, 1, 1, 1, 1],
      [0, 0, 1, 1, 1, 1, 1, 1, 1, 1],
      [0, 0, 1, 1, 1, 1, 1, 1, 1, 1],
      [0, 0, 1, 1, 1, 1, 1, 1, 1, 1],
      [0, 0, 1, 1, 1, 1, 1, 1, 1, 1],
      [0, 0, 1, 1, 1, 1, 1, 1, 1, 1],
      [0, 0, 1, 1, 1, 1, 1, 1, 1, 1],
      [0, 0, 1, 1, 1, 1, 1, 1, 1, 1],
      [0, 0, 1, 1, 1, 1, 1, 1, 1, 1],
      [0, 0, 1, 1, 1, 1, 1, 1, 1, 1]
    ]
  },
  {
    "position": [1, 1],
    "tile": [
      [1, 1, 1, 1, 1, 1, 1, 1, 1, 1],
      [1, 1, 1, 1, 1, 1, 1, 1, 1, 1],
      [1, 1, 1, 1, 1, 1, 1, 1, 1, 1],
      [1, 1, 1, 1, 1, 1, 1, 1, 1, 1],
      [1, 1, 1, 1, 1, 1, 1, 1, 1, 1],
      [1, 1, 1, 1, 1, 1, 1, 1, 1, 1],
      [1, 1, 1, 1, 1, 1, 1, 1, 1, 1],
      [1, 1, 1, 1, 1, 1, 1, 1, 1, 1],
      [1, 1, 1, 1, 1, 1, 1, 1, 1, 1],
      [1, 1, 1, 1, 1, 1, 1, 1, 1, 1]
    ]
  }
]
