[
  {
    "postion": [0, 0],
    "tile": [
      [0, 0, 0, 0, 0, 0, 0, 0, 0, 0],
      [0, 0, 0, 0, 0, 0, 0, 0, 0, 0],
      [0, 0, 0, 0, 0, 0, 0, 0, 0, 0],
      [0, 0, 0, 0, 0, 0, 0, 0, 0, 0],
      [0, 0, 0, 0, 0, 0, 0, 0, 0, 0],
      [0, 0, 0, 0, 0, 0, 0, 0, 0, 0],
      [0, 0, 0, 0, 0, 0, 0, 0, 0, 0],
      [0, 0, 0, 0, 0, 0, 0, 0, 0, 0],
      [0, 0, 0, 0, 0, 0, 0, 0, 0, 0],
      [0, 0, 0, 0, 0, 0, 0, 0, 0, 0]
    ],
    "npc": [
      {
        "id": 1,
        "name": "NPC 1",
        "tile": [1, 1],
        "tile_offset": [0, 0],
        "dialogue": false
      },
      {
        "id": 2,
        "name": "NPC 2",
        "tile": [4, 4],
        "tile_offset": [0, 0],
        "dialogue": false
      }
    ]
  },
  {
    "postion": [0, 1],
    "tile": [
      [0, 0, 0, 0, 0, 0, 0, 0, 0, 0],
      [0, 1, 1, 1, 1, 1, 1, 1, 1, 0],
      [0, 1, 0, 0, 0, 0, 0, 0, 1, 0],
      [0, 1, 0, 1, 1, 1, 1, 0, 1, 0],
      [0, 1, 0, 1, 2, 2, 1, 0, 1, 0],
      [0, 1, 0, 1, 2, 2, 1, 0, 1, 0],
      [0, 1, 0, 1, 1, 1, 1, 0, 1, 0],
      [0, 1, 0, 0, 0, 0, 0, 0, 1, 0],
      [0, 1, 1, 1, 1, 1, 1, 1, 1, 0],
      [0, 0, 0, 0, 0, 0, 0, 0, 0, 0]
    ]
  }
]
